***************************************************************
*     ...............                                         *
******************          ****         **********************
                 * .........* .*         *                     
                 *          * .*         *                     
                 *          * .*         *                     
                 *          * .*         *                     
******************          * .*         **********************
*                           * .*                              *
*                           * .*                              *
*                           * .*                              *
*                           * .*                              *
*                           * .*                              *
*                                                             *
***************************************************************
